%s An update is available=%s: En opdatering er tilgængelig
anonymous=Anonym
Author=Udgiver
Check For Updates=Søg Efter Opdateringer
Checking connectivity=Tjekker forbindelse
checking=tjekker
Click here to install version %s=Klik her for at installere version %s
Delete Plugin=Slet Plugin
DOWNGRADE TO VERSION=NEDGRADER TIL VERSION
ERROR=FEJL
Install Plugin=Installer Plugin
Install=Installer
install=installer
Installed Plugins=Installerede Plugins
Installing Update=Installerer Opdatering
Next=Næste
No plugins installed=Ingen plugins installeret
No release notes available=Ingen udgivelsesdetaljer tilgængelig
No response, aborting=Ingen respons, afbryder
Plugin File Install Errors=Plugin Fil Installations Fejl
Plugin File=Plugin Fil
Plugin History=Plugin Historik
Plugin Update Check=Plugin Opdaterings Tjek
Release Notes=Udgivelsesdetaljer
Remove Plugin=Fjern Plugin
remove=fjern
Select local plugin file=Vælg lokal plugin fil
Stable=Stabil
STALE=FORÆLDET
Uninstall=Afinstaller
Update All Plugins=Opdater alle plugins
Update Plugin=Opdater Plugin
Upgrade=Opgrader
View Release Notes=Vis Udgivelsesdetaljer

; Note: July 9, 2023 - 8 missing translations
Alert Message=
Enter URL of remote plugin file or local plugin file=
I have read the release notes=
need check=
Plugin=
Remove Selected Plugins=
Support Thread=
Update Incompatible=
